TILEMAP
56 30 							-- Size of tile map in tiles
16 32 							-- Tile size & block size
images/blockss.png 	-- Tilesheet
2 2 								-- Number of tiles in tilesheet
11111111111111111111111111111111111111111111111111111111
11                                                    11
11                                                    11
11                                                    11
11                                                    11
11                                                    11
11                                                    11
1111           1   1        1                         11
11           1 1 1 1 1                                11
11                                                    11
11                                                    11
11                                                    11
1111   1111   33   44                1111             11
11                                                    11
11                                                    11
11              111                                   11
11                                                    11
1111   111  22       22  1111   11                    11
11            22   22                                 11
11             22222                                  11
11                                                    11
1111          33   44                1111             11
11                                                    11
11                                                    11
1111          33   44                1111             11
11                                                    11
11                                                    11
11111111111111111111111111111111111111111111111111111111
22222222222222222222222222222222222222222222222222222222
22222222222222222222222222222222222222222222222222222222
22222222222222222222222222222222222222222222222222222222



